0 0 0 0 0 0 0 0 0 0 0 0 0 0 0 1 0 0 0 0 0 0 0 0 0 0 0 0 0 0 0 0
0 1 1 7 0 0 0 0 0 1 1 1 1 1 1 1 1 1 1 1 1 1 1 0 0 0 0 0 1 1 1 0
0 1 0 1 1 1 1 1 1 1 0 0 0 0 0 0 0 0 0 0 0 0 1 1 1 1 1 1 1 0 1 0
0 1 0 1 0 0 0 0 0 1 0 3 3 3 3 3 3 3 3 3 3 0 1 0 0 0 0 0 1 0 1 0
0 1 0 1 0 3 3 3 0 1 0 0 0 0 0 3 0 3 0 0 0 0 4 0 3 3 3 0 1 0 1 0
0 1 0 1 0 3 0 3 0 1 0 3 3 3 3 3 7 3 3 3 3 0 1 0 3 0 3 0 1 0 1 0
0 4 0 1 0 3 0 3 0 1 0 0 0 0 0 0 3 0 3 0 3 0 1 0 3 0 3 0 1 0 1 0
0 1 0 1 0 3 3 3 0 1 0 3 3 3 3 3 5 0 0 0 0 0 1 0 3 3 3 0 1 0 1 0
0 1 0 1 0 5 0 0 0 1 0 0 0 0 0 0 1 1 1 6 1 1 1 0 0 5 0 0 1 0 1 0
1 1 1 1 1 2 1 1 1 1 1 1 1 1 6 1 6 0 0 0 0 0 1 1 1 1 1 1 1 1 1 1
0 1 0 0 0 5 0 1 0 1 0 0 0 0 0 0 1 0 3 3 3 0 1 0 1 0 0 5 0 0 1 0
0 1 0 3 3 3 0 1 0 1 0 3 3 3 0 0 1 0 3 0 3 0 1 0 1 0 3 3 3 0 1 0
0 1 0 3 0 3 0 1 0 1 0 3 0 3 5 1 6 5 3 0 3 0 1 0 1 0 3 0 3 0 1 0
0 1 0 3 0 3 0 4 0 1 0 3 0 3 0 1 0 0 3 0 3 0 1 0 1 0 3 0 3 0 1 0
0 1 0 3 3 3 0 1 0 1 0 3 3 3 0 1 0 3 3 3 3 0 1 0 4 0 3 3 3 0 1 0
0 1 0 0 0 0 0 1 0 1 0 0 0 0 0 1 0 0 0 0 0 0 1 0 1 0 0 0 0 0 1 0
0 1 1 1 1 7 1 1 1 1 1 1 1 1 4 1 1 1 1 1 7 1 1 1 1 1 1 1 1 1 1 0
0 0 0 0 0 0 0 0 0 0 0 0 0 0 0 1 0 0 0 0 0 0 0 0 0 0 0 0 0 0 0 0